
log:
stranger_appeared

tiledefinition:
ceres_              ;ceres							                                      ;img/ceres/ceres_blocksize_2																;false				          ;0											           ;0			     ;0												;0				  ;0				  ;0										;0											;0													;0													;0										;0												;none						;none							;none									;unused0;unused1;unused2;unused3;unused4

global_system_actor:
#character           ;mapId ,spStatus   , direction , sensStatus, dialogFile, dialogueID
character           ;strang,,south,,,,

ACTORS:
#code 					         ;actorFileN																																								;IngameName															                  ;sprite-status						;sensor-status										;direction
trigge														;actorData/floor/trigger																											;Trigger																																				;ready														;fireOneTime												;undefined


layer:
#		 ;001			 ;002			 ;003			 ;004			 ;005			 ;006			 ;007				;008				;009			 ;010			 ;011			 ;012			 ;013			 ;014			 ;015			 ;016			 ;017			 ;018				;019				;020				;021				;022				;023				;024				;025				;026				;027				;028				;029				;030				;031				;032   ;033   ;034   ;035   ;036   ;037   ;038   ;039   ;040				;
001 ;______ ;______ ;______ ;______ ;______ ;______ ;______ ;______ ;______ ;______ ;______ ;______ ;______ ;______ ;______ ;______ ;______ ;______ ;______ ;______ ;______ ;______ ;______ ;______ ;______ ;______ ;______ ;______ ;ceres_ ;______ ;______ ;______;______;______;______;______;______;______;______;______ ;
002 ;______ ;______ ;______ ;______ ;______ ;______ ;______ ;______ ;______ ;______ ;______ ;______ ;______ ;______ ;______ ;______ ;______ ;______ ;______ ;______ ;______ ;______ ;______ ;______ ;______ ;______ ;______ ;______ ;______ ;______ ;______ ;______;______;______;______;______;______;______;______;______ ;
003 ;______ ;______ ;______ ;______ ;______ ;______ ;______ ;______ ;______ ;______ ;______ ;______ ;______ ;______ ;______ ;______ ;______ ;______ ;______ ;______ ;______ ;______ ;______ ;______ ;______ ;______ ;______ ;______ ;______ ;______ ;______ ;______;______;______;______;______;______;______;______;______ ;
004 ;______ ;______ ;______ ;______ ;______ ;______ ;______ ;______ ;______ ;______ ;______ ;______ ;______ ;______ ;______ ;______ ;______ ;______ ;______ ;______ ;______ ;______ ;______ ;______ ;______ ;______ ;______ ;______ ;______ ;______ ;______ ;______;______;______;______;______;______;______;______;______ ;
005 ;______ ;______ ;______ ;______ ;______ ;______ ;______ ;______ ;______ ;______ ;______ ;______ ;______ ;______ ;______ ;______ ;______ ;______ ;______ ;______ ;______ ;______ ;______ ;______ ;______ ;______ ;______ ;______ ;______ ;______ ;______ ;______;______;______;______;______;______;______;______;______ ;
006 ;______ ;______ ;______ ;______ ;______ ;______ ;______ ;______ ;______ ;______ ;______ ;______ ;______ ;______ ;______ ;______ ;______ ;______ ;______ ;______ ;______ ;______ ;______ ;______ ;______ ;______ ;______ ;______ ;______ ;______ ;______ ;______;______;______;______;______;______;______;______;______ ;
007 ;______ ;______ ;______ ;______ ;______ ;______ ;______ ;______ ;______ ;______ ;______ ;______ ;______ ;______ ;______ ;______ ;______ ;______ ;______ ;______ ;______ ;______ ;______ ;______ ;______ ;______ ;______ ;______ ;______ ;______ ;______ ;______;______;______;______;______;______;______;______;______ ;
008 ;______ ;______ ;______ ;______ ;______ ;______ ;______ ;______ ;______ ;______ ;______ ;______ ;______ ;______ ;______ ;______ ;______ ;______ ;______ ;______ ;______ ;______ ;______ ;______ ;______ ;______ ;______ ;______ ;______ ;______ ;______ ;______;______;______;______;______;______;______;______;______ ;
009 ;______ ;______ ;______ ;______ ;______ ;______ ;______ ;______ ;______ ;______ ;______ ;______ ;______ ;______ ;______ ;______ ;______ ;______ ;______ ;______ ;______ ;______ ;______ ;______ ;______ ;______ ;______ ;______ ;______ ;______ ;______ ;______;______;______;______;______;______;______;______;______ ;
010 ;______ ;______ ;______ ;______ ;______ ;______ ;______ ;______ ;______ ;______ ;______ ;______ ;______ ;______ ;______ ;______ ;______ ;______ ;______ ;______ ;______ ;______ ;______ ;______ ;______ ;______ ;______ ;trigge ;______ ;______ ;______ ;______;______;______;______;______;______;______;______;______ ;
011 ;______ ;______ ;______ ;______ ;______ ;______ ;______ ;______ ;______ ;______ ;______ ;______ ;______ ;______ ;______ ;______ ;______ ;______ ;______ ;______ ;______ ;______ ;______ ;______ ;______ ;______ ;______ ;______ ;______ ;______ ;______ ;______;______;______;______;______;______;______;______;______ ;
012 ;______ ;______ ;______ ;______ ;______ ;______ ;______ ;______ ;______ ;______ ;______ ;______ ;______ ;______ ;______ ;______ ;______ ;______ ;______ ;______ ;______ ;______ ;______ ;______ ;______ ;______ ;______ ;______ ;______ ;______ ;______ ;______;______;______;______;______;______;______;______;______ ;
013 ;______ ;______ ;______ ;______ ;______ ;______ ;______ ;______ ;______ ;______ ;______ ;______ ;______ ;______ ;______ ;______ ;______ ;______ ;______ ;______ ;______ ;______ ;______ ;______ ;______ ;______ ;______ ;______ ;______ ;______ ;______ ;______;______;______;______;______;______;______;______;______ ;
014 ;______ ;______ ;______ ;______ ;______ ;______ ;______ ;______ ;______ ;______ ;______ ;______ ;______ ;______ ;______ ;______ ;______ ;______ ;______ ;______ ;______ ;______ ;______ ;______ ;______ ;______ ;______ ;______ ;______ ;______ ;______ ;______;______;______;______;______;______;______;______;______ ;
015 ;______ ;______ ;______ ;______ ;______ ;______ ;______ ;______ ;______ ;______ ;______ ;______ ;______ ;______ ;______ ;______ ;______ ;______ ;______ ;______ ;______ ;______ ;______ ;______ ;______ ;______ ;______ ;______ ;______ ;______ ;______ ;______;______;______;______;______;______;______;______;______ ;
016 ;______ ;______ ;______ ;______ ;______ ;______ ;______ ;______ ;______ ;______ ;______ ;______ ;______ ;______ ;______ ;______ ;______ ;______ ;______ ;______ ;______ ;______ ;______ ;______ ;______ ;______ ;______ ;______ ;______ ;______ ;______ ;______;______;______;______;strang;______;______;______;______ ;
017 ;______ ;______ ;______ ;______ ;______ ;______ ;______ ;______ ;______ ;______ ;______ ;______ ;______ ;______ ;______ ;______ ;______ ;______ ;______ ;______ ;______ ;______ ;______ ;______ ;______ ;______ ;______ ;______ ;______ ;______ ;______ ;______;______;______;______;______;______;______;______;______ ;
018 ;______ ;______ ;______ ;______ ;______ ;______ ;______ ;______ ;______ ;______ ;______ ;______ ;______ ;______ ;______ ;______ ;______ ;______ ;______ ;______ ;______ ;______ ;______ ;______ ;______ ;______ ;______ ;______ ;______ ;______ ;______ ;______;______;______;______;______;______;______;______;______ ;
019 ;______ ;______ ;______ ;______ ;______ ;______ ;______ ;______ ;______ ;______ ;______ ;______ ;______ ;______ ;______ ;______ ;______ ;______ ;______ ;______ ;______ ;______ ;______ ;______ ;______ ;______ ;______ ;______ ;______ ;______ ;______ ;______;______;______;______;______;______;______;______;______ ;
020 ;______ ;______ ;______ ;______ ;______ ;______ ;______ ;______ ;______ ;______ ;______ ;______ ;______ ;______ ;______ ;______ ;______ ;______ ;______ ;______ ;______ ;______ ;______ ;______ ;______ ;______ ;______ ;______ ;______ ;______ ;______ ;______;______;______;______;______;______;______;______;______ ;
021 ;______ ;______ ;______ ;______ ;______ ;______ ;______ ;______ ;______ ;______ ;______ ;______ ;______ ;______ ;______ ;______ ;______ ;______ ;______ ;______ ;______ ;______ ;______ ;______ ;______ ;______ ;______ ;______ ;______ ;______ ;______ ;______;______;______;______;______;______;______;______;______ ;
022 ;______ ;______ ;______ ;______ ;______ ;______ ;______ ;______ ;______ ;______ ;______ ;______ ;______ ;______ ;______ ;______ ;______ ;______ ;______ ;______ ;______ ;______ ;______ ;______ ;______ ;______ ;______ ;______ ;______ ;______ ;______ ;______;______;______;______;______;______;______;______;______ ;
023 ;______ ;______ ;______ ;______ ;______ ;______ ;______ ;______ ;______ ;______ ;______ ;______ ;______ ;______ ;______ ;______ ;______ ;______ ;______ ;______ ;______ ;______ ;______ ;______ ;______ ;______ ;______ ;______ ;______ ;______ ;______ ;______;______;______;______;______;______;______;______;______ ;
024 ;______ ;______ ;______ ;______ ;______ ;______ ;______ ;______ ;______ ;______ ;______ ;______ ;______ ;______ ;______ ;______ ;______ ;______ ;______ ;______ ;______ ;______ ;______ ;______ ;______ ;______ ;______ ;______ ;______ ;______ ;______ ;______;______;______;______;______;______;______;______;______ ;
025 ;______ ;______ ;______ ;______ ;______ ;______ ;______ ;______ ;______ ;______ ;______ ;______ ;______ ;______ ;______ ;______ ;______ ;______ ;______ ;______ ;______ ;______ ;______ ;______ ;______ ;______ ;______ ;______ ;______ ;______ ;______ ;______;______;______;______;______;______;______;______;______ ;
026 ;______ ;______ ;______ ;______ ;______ ;______ ;______ ;______ ;______ ;______ ;______ ;______ ;______ ;______ ;______ ;______ ;______ ;______ ;______ ;______ ;______ ;______ ;______ ;______ ;______ ;______ ;______ ;______ ;______ ;______ ;______ ;______;______;______;______;______;______;______;______;______ ;
027 ;______ ;______ ;______ ;______ ;______ ;______ ;______ ;______ ;______ ;______ ;______ ;______ ;______ ;______ ;______ ;______ ;______ ;______ ;______ ;______ ;______ ;______ ;______ ;______ ;______ ;______ ;______ ;______ ;______ ;______ ;______ ;______;______;______;______;______;______;______;______;______ ;
028 ;______ ;______ ;______ ;______ ;______ ;______ ;______ ;______ ;______ ;______ ;______ ;______ ;______ ;______ ;______ ;______ ;______ ;______ ;______ ;______ ;______ ;______ ;______ ;______ ;______ ;______ ;______ ;______ ;______ ;______ ;______ ;______;______;______;______;______;______;______;______;______ ;
029 ;______ ;______ ;______ ;______ ;______ ;______ ;______ ;______ ;______ ;______ ;______ ;______ ;______ ;______ ;______ ;______ ;______ ;______ ;______ ;______ ;______ ;______ ;______ ;______ ;______ ;______ ;______ ;______ ;______ ;______ ;______ ;______;______;______;______;______;______;______;______;______ ;
030 ;______ ;______ ;______ ;______ ;______ ;______ ;______ ;______ ;______ ;______ ;______ ;______ ;______ ;______ ;______ ;______ ;______ ;______ ;______ ;______ ;______ ;______ ;______ ;______ ;______ ;______ ;______ ;______ ;______ ;______ ;______ ;______;______;______;______;______;______;______;______;______ ;
031 ;______ ;______ ;______ ;______ ;______ ;______ ;______ ;______ ;______ ;______ ;______ ;______ ;______ ;______ ;______ ;______ ;______ ;______ ;______ ;______ ;______ ;______ ;______ ;______ ;______ ;______ ;______ ;______ ;______ ;______ ;______ ;______;______;______;______;______;______;______;______;______ ;
032 ;______ ;______ ;______ ;______ ;______ ;______ ;______ ;______ ;______ ;______ ;______ ;______ ;______ ;______ ;______ ;______ ;______ ;______ ;______ ;______ ;______ ;______ ;______ ;______ ;______ ;______ ;______ ;______ ;______ ;______ ;______ ;______;______;______;______;______;______;______;______;______ ;
033 ;______ ;______ ;______ ;______ ;______ ;______ ;______ ;______ ;______ ;______ ;______ ;______ ;______ ;______ ;______ ;______ ;______ ;______ ;______ ;______ ;______ ;______ ;______ ;______ ;______ ;______ ;______ ;______ ;______ ;______ ;______ ;______;______;______;______;______;______;______;______;______ ;
034 ;______ ;______ ;______ ;______ ;______ ;______ ;______ ;______ ;______ ;______ ;______ ;______ ;______ ;______ ;______ ;______ ;______ ;______ ;______ ;______ ;______ ;______ ;______ ;______ ;______ ;______ ;______ ;______ ;______ ;______ ;______ ;______;______;______;______;______;______;______;______;______ ;
035 ;______ ;______ ;______ ;______ ;______ ;______ ;______ ;______ ;______ ;______ ;______ ;______ ;______ ;______ ;______ ;______ ;______ ;______ ;______ ;______ ;______ ;______ ;______ ;______ ;______ ;______ ;______ ;______ ;______ ;______ ;______ ;______;______;______;______;______;______;______;______;______ ;
036 ;______ ;______ ;______ ;______ ;______ ;______ ;______ ;______ ;______ ;______ ;______ ;______ ;______ ;______ ;______ ;______ ;______ ;______ ;______ ;______ ;______ ;______ ;______ ;______ ;______ ;______ ;______ ;______ ;______ ;______ ;______ ;______;______;______;______;______;______;______;______;______ ;
037 ;______ ;______ ;______ ;______ ;______ ;______ ;______ ;______ ;______ ;______ ;______ ;______ ;______ ;______ ;______ ;______ ;______ ;______ ;______ ;______ ;______ ;______ ;______ ;______ ;______ ;______ ;______ ;______ ;______ ;______ ;______ ;______;______;______;______;______;______;______;______;______ ;
038 ;______ ;______ ;______ ;______ ;______ ;______ ;______ ;______ ;______ ;______ ;______ ;______ ;______ ;______ ;______ ;______ ;______ ;______ ;______ ;______ ;______ ;______ ;______ ;______ ;______ ;______ ;______ ;______ ;______ ;______ ;______ ;______;______;______;______;______;______;______;______;______ ;
039 ;______ ;______ ;______ ;______ ;______ ;______ ;______ ;______ ;______ ;______ ;______ ;______ ;______ ;______ ;______ ;______ ;______ ;______ ;______ ;______ ;______ ;______ ;______ ;______ ;______ ;______ ;______ ;______ ;______ ;______ ;______ ;______;______;______;______;______;______;______;______;______ ;
040 ;______ ;______ ;______ ;______ ;______ ;______ ;______ ;______ ;______ ;______ ;______ ;______ ;______ ;______ ;______ ;______ ;______ ;______ ;______ ;______ ;______ ;______ ;______ ;______ ;______ ;______ ;______ ;______ ;______ ;______ ;______ ;______;______;______;______;______;______;______;______;______ ;
041 ;______ ;______ ;______ ;______ ;______ ;______ ;______ ;______ ;______ ;______ ;______ ;______ ;______ ;______ ;______ ;______ ;______ ;______ ;______ ;______ ;______ ;______ ;______ ;______ ;______ ;______ ;______ ;______ ;______ ;______ ;______ ;______;______;______;______;______;______;______;______;______ ;
042 ;______ ;______ ;______ ;______ ;______ ;______ ;______ ;______ ;______ ;______ ;______ ;______ ;______ ;______ ;______ ;______ ;______ ;______ ;______ ;______ ;______ ;______ ;______ ;______ ;______ ;______ ;______ ;______ ;______ ;______ ;______ ;______;______;______;______;______;______;______;______;______ ;
043 ;______ ;______ ;______ ;______ ;______ ;______ ;______ ;______ ;______ ;______ ;______ ;______ ;______ ;______ ;______ ;______ ;______ ;______ ;______ ;______ ;______ ;______ ;______ ;______ ;______ ;______ ;______ ;______ ;______ ;______ ;______ ;______;______;______;______;______;______;______;______;______ ;
044 ;______ ;______ ;______ ;______ ;______ ;______ ;______ ;______ ;______ ;______ ;______ ;______ ;______ ;______ ;______ ;______ ;______ ;______ ;______ ;______ ;______ ;______ ;______ ;______ ;______ ;______ ;______ ;______ ;______ ;______ ;______ ;______;______;______;______;______;______;______;______;______ ;
045 ;______ ;______ ;______ ;______ ;______ ;______ ;______ ;______ ;______ ;______ ;______ ;______ ;______ ;______ ;______ ;______ ;______ ;______ ;______ ;______ ;______ ;______ ;______ ;______ ;______ ;______ ;______ ;______ ;______ ;______ ;______ ;______;______;______;______;______;______;______;______;______ ;
046 ;______ ;______ ;______ ;______ ;______ ;______ ;______ ;______ ;______ ;______ ;______ ;______ ;______ ;______ ;______ ;______ ;______ ;______ ;______ ;______ ;______ ;______ ;______ ;______ ;______ ;______ ;______ ;______ ;______ ;______ ;______ ;______;______;______;______;______;______;______;______;______ ;
047 ;______ ;______ ;______ ;______ ;______ ;______ ;______ ;______ ;______ ;______ ;______ ;______ ;______ ;______ ;______ ;______ ;______ ;______ ;______ ;______ ;______ ;______ ;______ ;______ ;______ ;______ ;______ ;______ ;______ ;______ ;______ ;______;______;______;______;______;______;______;______;______ ;
048 ;______ ;______ ;______ ;______ ;______ ;______ ;______ ;______ ;______ ;______ ;______ ;______ ;______ ;______ ;______ ;______ ;______ ;______ ;______ ;______ ;______ ;______ ;______ ;______ ;______ ;______ ;______ ;______ ;______ ;______ ;______ ;______;______;______;______;______;______;______;______;______ ;
049 ;______ ;______ ;______ ;______ ;______ ;______ ;______ ;______ ;______ ;______ ;______ ;______ ;______ ;______ ;______ ;______ ;______ ;______ ;______ ;______ ;______ ;______ ;______ ;______ ;______ ;______ ;______ ;______ ;______ ;______ ;______ ;______;______;______;______;______;______;______;______;______ ;
050 ;______ ;______ ;______ ;______ ;______ ;______ ;______ ;______ ;______ ;______ ;______ ;______ ;______ ;______ ;______ ;______ ;______ ;______ ;______ ;______ ;______ ;______ ;______ ;______ ;______ ;______ ;______ ;______ ;______ ;______ ;______ ;______;______;______;______;______;______;______;______;______ ;

